|1111111110000000000000000000000000000000000000000000000000000000000000000000000000
|1111111110000000000000000000000000000000000000000000000000000000000000000000000000
|1111111110000000000000000000000000000000000000000000000000000000000000000000000000
|1111111111000000000000000000000000000000000000000000000000000000000000000000000000
|1111111111000000000000000000000000000000000000000000000000000000000000000000000000
|1111111111000000000000000000000000000000000000000000000000000000000000000000000000
|1111111110000000000000000000000000000000000000000000000000000000000000000110000000
|1111111111000000111000000000000000000000000000000000000000000000000000000111100001
|1111111111000011111000000000000000000000000011000000000000000000000000001111111111
|1111111111000011111100000000000000000000000011100000000000000000000111001111111111
|1111111111111111111111110000000000000000000111110000000011111000111111111111111111
|1111111111111111111111111111110011000000000111111100001111111111111111111111111111
|1111111111111111111111111111111111100000001111111111111111111111111111111111111111
|1111111111111111111111111111111111111111111111111111111111111111111111111111111111
|1111111111111111111111111111111111111111111111111111111111111111111111111111111111
|1111111111111111111111111111111111111111111111111111111111111111111111111111111111
|1111111111111111111111111111111111111111111111111111111111111111111111111111111111
|1111111111111111111111111111111111111111111111111111111111111111111111111111111111
|1111111111111111111111111111111111111111111111111111111111111111111111111111111111
|1111111111111111111111111111111111111111111111111111111111111111111111111111111111
|1111111111111111111111111111111111111111111111111111111111111111111111111111111111
|1111111111111111111111111111111111111111111111111111111111111111111111111111111111
|1111111111111111111111111111111111111111111111111111111111111111111111111111111111
|1111111111111111111111111111111111111111111111111111111111111111111111111111111111
|1111111111111111111111111111111111111111111111111111111111111111111111111111111111
|1111111111111111111111111111111111111111111111111111111111111111111111111111111111
|1111111111111111111111111111111111111111111111111111111111111111111111111111111111
|1111111111111111111111111111111111111111111111111111111111111111111111111111111111
|1111111111111111111111111111111111111111111111111111111111111111111111111111111111
|1111111111111111111111111111111111111111111111111111111111111111111111111111111111
|1111111111111111111111111111111111111111111111111111111111111111111111111111111111
|1111111111111111111111111111111111111111111111111111111111111111111111111111111111
|1111111111111111111111111111111111111111111111111111111111111111111111111111111111
|1111111111111111111111111111111111111111111111111111111111111111111111111111111111
|1111111111111111111111111111111111111111111111111111111111111111111111111111111111
|1111111111111111111111111111111111111111111111111111111111111111111111111111111111
|1111111111111111111111111111111111111111111111111111111111111111111111111111111111
|1111111111111111111111111111111111111111111111111111111111111111111111111111111111
|1111111111111111111111111111111111111111111111111111111111111111111111111111111111
|1111111111111111111111111111111111111111111111111111111111111111111111111111111111
|1111111111111111111111111111111111111111111111111111111111111111111111111111111111
|1111111111111111111111111111111111111111111111111111111111111111111111111111111111
