|00000000000000000000000000000000000000000000000000000000000000
|00000000000000000000000000000000000000000000000000000000000000
|00000000000000000000000000000000000000000000000000000000000000
|00000000000000000000000000000000000000000000000000000000000000
|00000000000000000000000000000000000000000000000000000000000000
|00000000000000000000000000000000000000000000000000000001100000
|00011111111000000000000000000000000111000000000000000011110000
|00011111111100110000000001100000000111100011100001000011111111
|00111111111101111110000011100001100111100111100011000011111111
|00111111111111111111000011111001110111111111110011111111111111
|01111111111111111111110111111111111111111111111111111111111111
|11111111111111111111111111111111111111111111111111111111111111
|11111111111111111111111111111111111111111111111111111111111111
|11111111111111111111111111111111111111111111111111111111111111
|11111111111111111111111111111111111111111111111110111111111111
|11111111111111111111111111111111111111111111111111111111111111
|11111111111111111111111111111111111111111111111111111111111111
|11111111111111111111111111111111111111111111111111111111111111
|11111111111111111111111111111111111111111111111111111111111111
|11111111111111111111111111111111111111111111111111111111111111
|11111111111111111111111111111111111111111111111111111111111111
|11111111111111111111111111111111111111111111111111111111111111
|11111111111111111111111111111111111111111111111111111111111111
|11111111111111111111111111111111111111111111111111111111111111
|11111111111111111111111111111111111111111111111111111111111111
|11111111111111111111111111111111111111111111111111111111111111
|11111111111111111111111111111111111111111111111111111111111111
|11111111111111111111111111111111111111111111111111111111111111
|11111111111111111111111111111111111111111111111111111111111111
|11111111111111111111111111111111111111111111111111111111111111
|11111111111111111111111111111111111111111111111111111111111111
|11111111111111111111111111111111111111111111111111111111111111
|11111111111111111111111111111111111111111111111111111111111111
|11111111111111111111111111111111111111111111111111111111111111
|11111111111111111111111111111111111111111111111111111111111111
|11111111111111111111111111111111111111111111111111111111111111
|11111111111111111111111111111111111111111111111111111111111111
|11111111111111111111111111111111111111111111111111111111111111
|11111111111111111111111111111111111111111111111111111111111111
|11111111111111111111111111111111111111111111111111111111111111
|11111111111111111111111111111111111111111111111111111111111111
|11111111111111111111111111111111111111111111111111111111111111
